广州	gz
深圳	sz
香港	xg
上海	sh
北京	bj
成都	cd---
重庆	cq
沈阳	sy
郑州	zz
长沙	cs
宁波	nb
长春	cc
杭州	hz
大连	dl
太原	ty
南宁	nn
贵阳	gy
青岛	qd
澳门	am
武汉	wh
南昌	nc
福州	fz
西安	xa
南京	nj
汕头	st
天津	tj
温州	wz
珠海	zh
三亚	sya
海口	hk
昆明	km
济南	jn
哈尔滨	heb
